keyword,acte,meig,geovis,strudel,total
data,8,7,5,15,35
point cloud,30,0,16,19,65
segmentation,9,4,5,21,39
city model,9,2,10,13,34
deep learning,10,22,3,26,61
sustainable development goals sdg,0,1,0,0,1
large language model llm,0,1,0,0,1
knowledge graph kg,0,1,0,0,1
open science,1,6,3,1,11
schema mapping,0,1,0,0,1
image,13,8,8,11,40
ranking,0,0,0,1,1
average precision,0,0,0,1,1
hierarchical ranking,0,0,0,1,1
hierarchical average precision,0,0,0,1,1
non-decomposable,0,0,0,1,1
remote sensing hyperspectral benthic habitats bathymetry desis,1,0,0,0,1
art analysis,0,0,0,1,1
zero-shot,0,0,0,1,1
weakly supervised learning,0,0,0,1,1
object detection,3,0,0,4,7
stable diffusion,0,0,0,1,1
eure valley,0,0,0,1,1
archaeology,0,0,0,1,1
geomorphology,0,0,0,1,1
vallée de l'eure,0,0,0,1,1
archéologie,1,0,0,1,2
géomorphologie,0,0,0,1,1
green cartography,0,1,1,0,2
green computing,0,1,1,0,2
web mapping,0,1,2,0,3
tiling,0,1,1,0,2
generalization,0,52,12,0,64
gan,0,1,0,1,2
steganography,0,0,0,1,1
image translation,0,0,0,1,1
digital humanities,9,1,1,34,45
visualisation,4,7,19,11,41
planning,4,11,8,29,52
deep leaning,0,0,0,1,1
remote sensing,19,0,2,32,53
earth observation,0,0,0,2,2
diffusion models,0,0,0,1,1
generative ai,0,0,0,1,1
nature en ville,0,2,0,2,4
risque tique,0,2,0,2,4
model exploration,1,4,1,19,25
spatial analysis,3,16,0,15,34
acteurs publics,0,2,0,2,4
enquête,0,1,0,1,2
city information modeling cim,0,0,1,0,1
intensity of uses,0,0,1,0,1
district,0,0,1,0,1
numérisation,1,0,1,1,3
gt données numériques,1,0,1,1,3
language,0,17,0,13,30
cahiers citoyens,0,3,0,1,4
grand débat national,0,1,0,0,1
corpus,0,3,0,1,4
modèle de langue,0,1,0,0,1
vecteur de plongement,0,1,0,0,1
classification,9,5,3,34,51
machine learning,13,14,3,22,52
réduction de dimensions,0,1,0,0,1
urban,3,2,2,5,12
urbain du futur,0,1,0,0,1
science-fiction,0,1,0,0,1
gps / gnss,11,2,1,6,20
pattern,0,2,1,1,4
outdoor recreation,0,0,0,1,1
pauses,0,0,0,1,1
time- geography,0,0,0,1,1
geohistory,5,5,2,28,40
hierarchical representation,0,0,0,1,1
musical grammar,0,0,0,1,1
rhythmic tree,0,0,0,1,1
style,0,6,14,7,27
accessibility,0,8,6,0,14
knowledge,1,9,0,11,21
geocoding,0,11,3,6,20
semantics,4,16,3,38,61
ontology population,0,0,0,1,1
gis,2,12,9,20,43
buildings,3,4,6,11,24
change detection,4,2,1,6,13
quality,4,23,4,15,46
collaborative,0,2,0,3,5
spatiotemporal phenomena,1,0,0,0,1
reliability,1,0,0,0,1
proposals,1,0,0,0,1
intelligent robots,1,0,0,0,1
three-dimensional displays,1,0,0,0,1
multimodal sensors,1,0,0,0,1
rendering computer graphics,1,0,0,0,1
calibration,2,0,0,0,2
honey beeswaggle dancegeolocationspatial accuracygeovisualizationcartography,1,1,0,0,2
recherche d'image par contenu visuel,1,0,0,1,2
estimation de pose,2,0,0,2,4
données patrimoniales,1,0,0,1,2
scale factor,1,0,0,0,1
multi-resolution images,1,0,0,0,1
relative radiometric normalization,1,0,0,0,1
scalable,0,0,0,1,1
superpoint,0,0,0,2,2
graph clustering,0,0,0,1,1
lightweight,0,0,0,2,2
efficient,0,0,0,3,3
latent space,1,0,0,1,2
web maps,0,1,1,0,2
zooming,0,4,3,0,7
interaction,5,7,5,5,22
coordinate reference systems,0,0,0,1,1
spatial reference systems,0,0,0,1,1
geosparql,0,0,0,1,1
enquêtes,0,1,0,1,2
analyse du cycle de vie projets urbains spatialisation régionalisation géodonnées besoins systèmes d'information géographique sig life cycle analysis lca urban projects spatialisation regionalisation geodata geographical information systems gis,0,0,1,0,1
analyse du cycle de vie,0,0,1,0,1
projets urbains,0,0,2,0,2
spatialisation,0,0,1,0,1
régionalisation,0,0,1,0,1
géodonnées,0,0,2,0,2
besoins,0,0,1,0,1
systèmes d'information géographique sig life cycle analysis lca,0,0,1,0,1
urban projects,0,0,2,0,2
regionalisation,0,0,1,0,1
geographical information systems gis,0,0,1,0,1
applied computer science,0,0,0,1,1
graph,1,1,0,3,5
mobility,3,7,8,16,34
experimental in-situ multi-sensors gnss trajectories,0,1,0,0,1
crowdsourced trajectory,0,1,0,0,1
trajectory aggregation,0,2,0,0,2
re-ranking,3,0,0,2,5
visual and spatial collection structuring,1,0,0,0,1
graph-based visualization and structuring,1,0,0,0,1
recherche d'images par contenu visuel,1,0,0,0,1
re-ordonnancement des résultats,1,0,0,0,1
structuration visuelle et spatiale des collections,1,0,0,0,1
structuration et visualisation basée graphe,1,0,0,0,1
road,0,8,4,3,15
district scale,0,0,2,0,2
neighborhood scale,0,0,1,0,1
vault diagnosis,1,0,0,0,1
notre-dame de paris cathedral,1,0,0,0,1
2d/3d alignment,1,0,0,0,1
photogrammetry,10,0,1,2,13
ner/nel,0,9,0,23,32
radar sensors,1,0,0,0,1
c band,1,0,0,0,1
tree crops monitoring,1,0,0,0,1
band c,1,0,0,0,1
suivi cultures arbirées,1,0,0,0,1
capteurs radar,1,0,0,0,1
ocr,0,0,0,9,9
neo4j,0,1,0,0,1
sdg,0,1,0,0,1
uml,0,2,0,0,2
odd,0,1,0,0,1
ccs concepts information systems → top-k retrieval in databases image search • human-centered computing → interactive systems and tools visualization • applied computing → arts and humanities image retrieval,1,0,0,1,2
graph visualization,3,0,0,3,6
geographical iconographic heritage,1,0,0,1,2
ccs concepts,1,0,0,1,2
information systems → top-k retrieval in databases,1,0,0,1,2
image search,1,0,0,1,2
• human-centered computing → interactive systems and tools,1,0,0,1,2
• applied computing → arts and humanities image retrieval,1,0,0,1,2
volunteered citizen words,0,1,0,1,2
textometric analysis,0,1,0,1,2
spatialized corpus analysis,0,1,0,1,2
useless word,0,1,0,1,2
contribution citoyenne,0,1,0,1,2
analyse textométrique,0,1,0,1,2
analyse spatiale de corpus,0,1,0,1,2
mot inutilisable,0,1,0,1,2
reconstruction,16,0,3,4,23
location,0,0,0,1,1
spatial source,0,0,0,1,1
simulation,0,9,3,24,36
digital twin,1,1,1,3,6
polyhedral modeling,1,0,1,0,2
half-edge structure,1,0,1,0,2
plane arrangements,1,0,1,0,2
multimodal data linking,2,0,0,2,4
iconographic heritage,2,0,0,2,4
structuring,2,0,0,2,4
discoverability,2,0,0,2,4
investigation,2,0,0,2,4
surface continentale,1,0,0,0,1
changement climatique,1,0,0,0,1
efficiency,0,0,0,1,1
multimodal learning,0,0,0,2,2
sober ai,0,0,0,2,2
efficacité,0,0,0,1,1
apprentissage multi-modal,0,0,0,1,1
sobriété,0,0,0,1,1
few shot classification,0,0,0,1,1
prompt learning,0,0,0,1,1
local and global prompts,0,0,0,1,1
robustness,0,1,0,2,3
ood detection,0,0,0,1,1
computer vision and pattern recognition cscv,0,0,0,1,1
fos computer and information sciences,0,0,0,1,1
python library,0,2,0,0,2
matching,6,8,2,9,25
synthetic trajectory,0,1,0,0,1
ccs concepts • information systems → spatial-temporal systems trajectory aggregation,0,1,0,0,1
synthetic and real world trajectories,0,1,0,0,1
documentation photographique,0,0,1,0,1
réalité virtuelle,0,0,1,0,1
réalité mixte,0,0,1,0,1
études collaboratives,0,0,1,0,1
sciences du patrimoine,0,0,1,0,1
neologism,0,1,0,0,1
textometry,0,2,0,0,2
science fiction,0,2,0,0,2
habitat,0,0,0,1,1
fox,0,0,0,1,1
cartography,0,40,13,19,72
lulc,2,10,0,22,34
environment,3,3,1,4,11
large language model,0,1,0,1,2
named entity linking,0,1,0,1,2
correlation matrix,0,0,0,1,1
low-rank factorization,0,0,0,2,2
majorization-minimization,0,0,0,1,1
robust estimation,0,0,0,1,1
epidemiology modeling tool,0,0,0,1,1
saliency,0,1,1,0,2
eye-tracking,0,2,2,0,4
place recognition,1,0,0,1,2
qualitative location,1,0,0,1,2
qualitative spatial relation,1,0,0,1,2
place descriptor,1,0,0,1,2
place signature,1,0,0,1,2
radiometric harmonization,1,0,0,0,1
cyclegan,1,0,0,0,1
graph learning,0,0,0,2,2
gaussian graphical models,0,0,0,1,1
optimisation,5,3,2,13,23
very high-resolution vhr imagery,0,1,0,1,2
nlp - disambiguation - polysemy - camembert - embedding vector - fine tuning - classification - city - science fiction - corpus,0,1,0,0,1
tal - désambiguïsation - polysémie - camembert - vecteur de plongement - affinement - classification - ville - science fiction - corpus,0,1,0,0,1
analyse sémantique,0,1,0,0,1
life cycle assessment,0,0,1,0,1
shading masks,0,0,1,0,1
energy needs,0,0,1,0,1
building simulation,0,0,1,0,1
analyse de cycle de vie,0,0,1,0,1
masques solaires,0,0,1,0,1
besoins énergétiques,0,0,1,0,1
simulation thermique dynamique,0,0,1,0,1
geospatial data,0,0,0,1,1
large-scale,0,0,0,3,3
apprentissage multimodal,0,0,0,1,1
efficace,0,0,0,1,1
grande échelle,0,0,0,1,1
ia sobre,0,0,0,1,1
bande dessinée,0,1,1,0,2
street intersections,0,0,1,0,1
automation,4,2,3,1,10
multi-modal data fusion,0,0,0,1,1
pre-training,0,0,0,1,1
vision,7,0,0,6,13
integration,2,5,0,13,20
imaging spectroscopy signal-to-noise ratio spectral sampling image quality mineralogy soil moisture content tree species leaf functional traits bottom classification shallow water bathymetry seabed urban land cover plume aerosols methane,0,0,0,1,1
maritime ,0,7,0,8,15
nested spatial entity,0,1,0,1,2
binary spatial relation,0,1,0,1,2
computing methodologies → artificial intelligence natural language processing information extraction geographic information,0,1,0,1,2
computing methodologies → artificial intelligence,0,1,0,1,2
information extraction geographic information,0,1,0,1,2
geographic information science,0,0,0,1,1
science de l'information géographique,0,0,0,1,1
complex systems,0,0,0,3,3
harmonisation,0,1,0,3,4
nomenclature,0,0,0,3,3
translation,0,0,0,4,4
traduction,0,0,0,1,1
imagerie satellite,1,0,0,1,2
retour d'expérience,0,0,1,0,1
fast,0,0,0,1,1
hierarchical partition,0,0,0,1,1
transformer,0,0,0,1,1
disorientation,0,2,1,0,3
zoom,0,3,2,0,5
pan,0,1,0,0,1
desert fog,0,2,1,0,3
user survey,0,1,0,0,1
semantic meshes,1,0,0,0,1
lod1,1,0,0,0,1
pleiades-hr images,1,0,0,0,1
missing data,0,0,0,2,2
maximum likelihood,0,0,0,1,1
expectation-maximization algorithm,0,0,0,1,1
elliptical distributions,0,0,0,1,1
catalogage de ressources,0,0,1,1,2
documentation de corpus de recherche,0,0,1,1,2
citizen science,0,35,1,9,45
intrinsic qualification,0,1,0,0,1
spatial accuracy,0,1,0,0,1
dempster-shafer theory,0,1,0,1,2
geographic iconographic heritage,1,0,0,1,2
content interlinking,1,0,0,1,2
nested named entity recognition,0,0,0,1,1
optical character recognition,0,0,0,1,1
sensitive map,0,7,0,7,14
source of information,0,1,0,1,2
experiment,0,1,0,1,2
information selection,0,1,0,1,2
map analysis,0,1,0,2,3
fisheye camera geolocation ground-based matching horizon line contour lidar,1,0,0,0,1
fisheye camera,1,0,0,0,1
localisation,8,1,1,7,17
ground-based,1,0,0,0,1
horizon line contour,1,0,0,0,1
radial distance,0,1,0,0,1
shape similarity,0,1,0,0,1
polygon data matching,0,1,0,0,1
error propagation,0,1,1,0,2
entry separation,0,0,0,1,1
layout analysis,0,0,0,1,1
text token classication,0,0,0,1,1
multi-modal features,0,0,0,1,1
ecodesign,0,0,2,0,2
software,0,1,2,0,3
neighborhood,0,0,1,0,1
geodata discovery,0,1,0,0,1
portal,0,1,0,0,1
nested name entity recognition,0,0,0,1,1
pre-trained language models,0,0,0,1,1
ner on noisy texts,0,0,0,1,1
search engines,0,1,0,0,1
knowledge graphs,0,1,0,0,1
relevance,0,1,0,0,1
spatial datasets,0,1,0,0,1
métadonnées géographiques,0,1,0,0,1
moteurs de recherche,0,1,0,0,1
graphes de connaissances,0,1,0,0,1
pertinence,0,1,0,0,1
jeux de données géographiques,0,1,0,0,1
signal processing,5,0,0,5,10
multimedia,5,0,0,5,10
education,0,2,0,0,2
map stories,0,1,0,0,1
edugeo,0,1,0,0,1
automated mapping,0,0,1,0,1
orientation et mobilité,0,0,1,0,1
déficience visuelle,0,0,1,0,1
cartographie automatisée,0,0,1,0,1
warning sirens,0,0,0,1,1
audibility of sound sources,0,0,0,1,1
noise mapping,0,0,0,1,1
noisemodelling,0,0,0,1,1
audibility maps,0,0,0,1,1
honeybee,1,1,0,0,2
waggle dance,1,1,0,0,2
animal communication,1,1,0,0,2
foraging,1,1,0,0,2
behaviour,1,1,0,0,2
supervised classification,0,0,0,1,1
geospatial imagery,0,0,0,4,4
imagerie géospatiale,0,0,0,1,1
détection de changement,0,0,0,1,1
cameroun,0,0,0,1,1
workflow,0,1,0,0,1
map generalisation generative adversarial network deep learning workflow,0,1,0,0,1
mental map,0,1,1,0,2
memory,0,1,1,0,2
cartes transscalaires,0,1,1,0,2
radical cartography,0,1,0,1,2
3d model,5,3,3,6,17
graph-cut,2,0,1,1,4
poisson,1,0,0,0,1
delaunay-graph neural network,1,0,0,0,1
point set structuring,1,0,0,0,1
robust and efficient surface reconstruction,1,0,0,0,1
smooth signed distance,1,0,0,0,1
qgis,0,1,0,0,1
relation spatiale,0,1,0,0,1
zone montagneuse,0,1,0,0,1
mountain rescue,0,6,0,0,6
semantic enhancement,0,1,0,0,1
spatial data enrichment,0,1,0,0,1
infectious disease,0,0,0,1,1
low-rank factor models,0,0,0,1,1
generation,2,3,2,2,9
spatial relations recognition,0,1,0,1,2
language model training,0,1,0,1,2
entraînement de modèles de langue,0,1,0,1,2
data extraction,0,0,0,1,1
image registration,0,0,0,1,1
analyse de cartes,0,0,0,1,1
extraction d'informations,0,0,0,1,1
recalage d'images,0,0,0,1,1
radiative transfer,1,0,0,0,1
seabed analysis,1,0,0,0,1
estimation,1,0,0,0,1
uncertainty,1,1,1,1,4
fisher information,1,0,0,0,1
perception,0,4,2,2,8
cartographic anchors,0,1,0,0,1
cartographic landmarks,0,2,0,0,2
data enrichment,1,1,0,1,3
systematic review,0,0,0,1,1
progressiveness,0,1,1,0,2
sustainability,0,2,0,4,6
rationalities,0,1,0,1,2
future urban,0,1,0,0,1
dimension reduction,0,1,0,0,1
intelligence artificielle,1,1,0,0,2
outil conversationnel,1,0,0,0,1
chatgpt,1,0,0,0,1
dall·e,1,0,0,0,1
génération automatique de code,1,0,0,0,1
multilatération,1,0,0,0,1
parangonnage,1,0,0,0,1
pan-scalar map,0,1,0,0,1
spatial cognition,0,1,0,0,1
cycling,0,1,0,0,1
lightweight ontology,0,1,0,1,2
semantic landmarks,0,1,0,1,2
mountain rescue operation,0,1,0,1,2
web based mapping,0,1,0,0,1
structuralism,0,1,0,0,1
surface reconstruction point clouds deep learning mesh generation survey benchmark,1,0,0,1,2
survey,1,1,0,1,3
satellite photogrammetry,1,0,0,0,1
auto-calibration,1,0,0,0,1
surface 3d deformation,1,0,0,0,1
cubesat,1,0,0,0,1
photogrammétrie par satellite,1,0,0,0,1
déformation 3d,1,0,0,0,1
réseaux génératifs antagonistes,0,1,0,0,1
geo-located information,0,1,0,0,1
pollution,0,5,0,0,5
institutional database,0,1,0,0,1
information géolocalisée,0,1,0,0,1
pollution industrielle,0,1,0,0,1
base de données institutionnelle,0,1,0,0,1
ville intelligente,0,1,0,0,1
panneaux d’affichage numérique,0,1,0,0,1
point d’intérêts,0,1,0,0,1
systèmes d'information géographique,0,1,0,0,1
shapelets,0,0,0,1,1
constrained clustering,0,0,0,1,1
time-series,1,0,0,4,5
representation learning,0,0,0,1,1
multimodal deep learning,0,1,0,0,1
constraint,0,2,1,0,3
design,0,1,2,0,3
réseau hydrographique,0,1,1,0,2
analyses urbaines,0,0,1,0,1
intensité urbaine,0,0,1,0,1
quartier,0,0,1,0,1
préconisations,0,0,1,0,1
nested ner,0,0,0,1,1
change detection semi-supervised learning unsupervised learning clustering multitemporal images deep learning,0,0,0,1,1
unsupervised learning,0,0,0,1,1
multitemporal images,0,0,0,1,1
sailing directions,0,1,0,1,2
statistical analysis,0,1,0,0,1
tree cloud,0,1,0,0,1
analyse statistique,0,1,0,0,1
nuage arboré,0,1,0,0,1
textométrie,0,1,0,0,1
forest,4,0,1,2,7
radar,8,0,0,5,13
grasslands,0,0,0,1,1
ecosystem services,0,0,0,1,1
séries temporelles,0,0,0,1,1
change,1,0,0,1,2
prairies,0,0,0,1,1
services écosystémiques,0,0,0,1,1
computer science,1,0,0,0,1
crisis management,0,1,1,1,3
topology,0,0,0,1,1
shortest path,0,0,0,1,1
leakage loss,0,0,0,1,1
data collection and validation,0,1,0,1,2
euro sdr,0,1,0,1,2
projective texturing,0,0,3,0,3
multiple criteria analysis,0,1,0,0,1
electre,0,1,0,0,1
promethee,0,1,0,0,1
thematic mapping,0,1,0,0,1
maps for people with visual impairments,0,1,0,0,1
3d printing,0,2,1,0,3
red fox,0,0,0,1,1
multi-source data,0,0,0,1,1
landscape planning,0,0,0,1,1
intersection,0,1,0,0,1
data model,0,1,0,0,1
geographic metadata,0,1,0,0,1
iso 19115,0,1,0,0,1
iso 19157,0,1,0,0,1
design principles,0,1,0,0,1
standardization,0,1,0,0,1
symbology,0,1,0,0,1
production methods,0,1,0,0,1
guidelines,0,1,0,0,1
climate,0,1,1,1,3
urbanvis,0,0,1,1,2
spatial data infrastructures,0,1,0,0,1
geospatial descriptors,2,0,0,2,4
graph embeddings,1,0,0,1,2
évaluation de la qualité,0,1,0,0,1
time series,0,0,0,7,7
series temporelles,0,0,0,1,1
visual cognition,0,1,0,0,1
perceptual survey,0,1,0,0,1
time sereis representation,0,0,0,1,1
shapelets de séries temporelles,0,0,0,1,1
cavity excavation,1,0,0,0,1
fluid extraction,1,0,0,0,1
ground surface deformation,1,0,0,0,1
human activity,1,0,0,0,1
space-based geodetic tool,1,0,0,0,1
spaceborne synthetic aperture radar,1,0,0,0,1
interferometric techniques,1,0,0,0,1
subsurface anthropogenic activity,1,0,0,0,1
water-management strategies,1,0,0,0,1
analogue photography,0,0,2,2,4
orthophotomosaic,0,0,2,2,4
radiometry,0,0,2,2,4
hotspot correction,0,0,2,2,4
karhunen-loève transform,0,0,1,1,2
wallis adaptive filter,0,0,1,1,2
spatial auto-correlation,0,0,1,1,2
mathematical morphology,0,0,1,1,2
multi-scale analysis,0,0,1,1,2
computational cartography,0,1,0,0,1
cartographie -- informatique,0,1,0,0,1
urban scale,0,0,1,0,1
digital transition,0,0,1,0,1
iot,0,0,1,0,1
validation methods and products,0,0,0,1,1
nordic and arctic cities,0,0,0,1,1
south cities,0,0,0,1,1
urban change modelling,0,0,0,1,1
urban fabric mapping,0,0,0,1,1
georeferencing,2,5,0,5,12
public transport disruption,0,0,0,1,1
observation filters,0,1,0,1,2
urban space,0,1,0,1,2
optical image processing,1,0,0,0,1
data completeness,0,1,0,0,1
sensor data,0,1,0,0,1
mobile mapping,9,1,5,1,16
air quality,0,1,0,0,1
data completeness improvement,0,1,0,0,1
constraints,0,6,0,0,6
virtual geographic environment,0,1,1,0,2
online user study,0,1,1,0,2
training dataset,0,1,0,1,2
jeu de données d'entraînement,0,1,0,1,2
multi-epoch,2,0,0,0,2
pose estimation,6,0,0,2,8
self-calibration,1,0,0,0,1
appariement des caractéristiques,1,0,0,0,1
multi-époques,1,0,0,0,1
estimation de la pose,1,0,0,0,1
auto-étalonnage,1,0,0,0,1
securite,0,0,0,1,1
alerte,0,0,0,1,1
acoustique,0,0,0,1,1
source sonore,0,0,0,1,1
cultural heritage ch,0,1,0,0,1
global change,0,1,0,0,1
spatial dataset search,0,1,0,0,1
metadata clustering,0,1,0,0,1
search engine,0,1,0,0,1
metadata standards,0,1,0,0,1
similarity measure,0,1,0,0,1
web gis,0,1,0,0,1
coastal maritime environment,0,1,0,1,2
reconstruction de surfaces,1,0,0,0,1
model 3d,1,0,0,0,1
maquette,1,0,0,0,1
annotation cost,0,0,0,1,1
ancient text,0,0,0,1,1
ocr errors,0,0,0,1,1
bert,0,0,0,1,1
textes anciens,0,0,0,1,1
vocabulaires liés,0,0,0,1,1
submersion marine,0,0,0,1,1
la rochelle,0,0,0,1,1
tempête,0,0,0,1,1
surcôte,0,0,0,1,1
risque,0,0,0,1,1
vegetation,2,0,0,7,9
capteur,1,0,0,0,1
surveillance,2,0,0,0,2
ouvrage d'art,1,0,0,0,1
structure,1,0,0,0,1
geotagging,0,1,0,1,2
dual-encoder,0,1,0,1,2
mention detection,0,1,0,1,2
double encodeur,0,1,0,1,2
annotation sémantique,0,1,0,1,2
historical aerial photographs landslides micmac south italy dsm comparison,1,0,0,0,1
landslides,1,0,0,0,1
micmac,3,0,0,0,3
south italy,1,0,0,0,1
dsm comparison,1,0,0,0,1
massive imports,0,1,0,0,1
evolution analysis,0,1,0,0,1
evolution patterns,0,1,0,0,1
archives géographiques,0,0,0,1,1
cartography -- computer science,0,1,0,0,1
environnement maritime côtier instructions nautiques navigation maritime côtière ontologie coastal maritime environment instructions nautiques coastal maritime navigation ontology,0,1,0,1,2
ontologie coastal maritime environment,0,1,0,1,2
sdgs,0,0,0,1,1
lasergrammétrie,1,0,0,0,1
uav,11,0,0,0,11
maillage,1,0,0,0,1
visite virtuelle,1,0,0,0,1
contrôle qualité,1,0,0,0,1
coupe,1,0,0,0,1
écorché,1,0,0,0,1
multitechnique,1,0,0,0,1
acl,0,1,0,1,2
operational,0,0,0,3,3
country-scale,0,0,0,1,1
low-level ontology development,0,1,0,1,2
ontology development methodology,0,1,0,1,2
seed ontology,0,1,0,1,2
technical domain,0,1,0,1,2
cognitive mapping,0,1,1,0,2
drawing,0,1,1,0,2
cognitive science,0,1,1,0,2
hyperspectral imagery,0,0,0,1,1
impervious surface,0,0,0,1,1
solar panels,0,0,0,1,1
image hyperspectrale,0,0,0,1,1
surfaces imperméables,0,0,0,1,1
végétation,0,0,0,1,1
panneaux photovoltaïques,0,0,0,1,1
point sampling,1,0,0,0,1
content-based retrieval,1,0,0,1,2
similarity metrics,1,0,0,1,2
multimodal data analytics,1,0,0,1,2
observatories,1,0,0,0,1
reflection,1,0,0,0,1
multi-scale anchor,0,1,0,0,1
pattern detection,0,1,0,0,1
embedded systems,1,0,0,0,1
tracking,2,0,1,0,3
camera,1,0,0,0,1
imu,2,0,0,0,2
ekf,1,0,0,0,1
systèmes embarqués,1,0,0,0,1
suivi,1,0,0,0,1
caméra,1,0,0,0,1
territory evolution,1,0,0,1,2
covid-19,0,1,0,0,1
geomasking,0,1,0,0,1
spatial anonymization,0,1,0,0,1
k-anonymity,0,1,0,0,1
epipolar rectification,1,0,0,0,1
generic camera,1,0,0,0,1
pushbroom sensor,1,0,0,0,1
central perspective,1,0,0,0,1
smart cities,1,1,0,1,3
cultural,1,1,0,1,3
synergy,1,1,0,1,3
spatial information infrastructures,1,1,0,1,3
word embedding,0,1,0,0,1
semantic annotation,0,1,0,0,1
photographie aérienne,1,0,0,1,2
indexation par contenu,1,0,0,1,2
records in contexts ontology ric-o,1,0,0,1,2
plateforme web de navigation,1,0,0,1,2
rdf,1,0,0,1,2
données ouvertes liées,1,0,0,1,2
bathymetry,0,0,0,1,1
navigation,0,0,0,1,1
sedimentology,0,0,0,1,1
life story,0,5,0,5,10
local moran’s index,0,1,0,1,2
deep-learning,0,0,0,1,1
semantic,0,0,0,1,1
resolution,0,6,2,6,14
occupation / usage du sol,0,0,0,1,1
semantique,0,0,0,1,1
convolutional neural network,0,0,0,1,1
geographical encoding,0,0,0,1,1
• computing methodologies → feature selection,1,0,0,1,2
image representations,1,0,0,1,2
• information systems → image search,1,0,0,1,2
graph embedding,1,0,0,1,2
contrastive learning,1,0,0,1,2
gcn,1,0,0,1,2
virtual geographic environments,0,1,1,0,2
3d geovisualization,0,1,1,0,2
strategic behavior,0,1,1,0,2
geographic knowledge base,0,0,0,1,1
base de connaissances géographiques,0,0,0,1,1
optical,0,0,0,1,1
agriculture,0,0,0,3,3
operational system,0,0,0,1,1
country scale,0,0,0,1,1
lpis,0,0,0,1,1
optical target target orientation image processing algorithm geometry ellipse fitting computer vision overexposure exposure compensation resection,1,0,0,0,1
archival records metadata,0,0,0,1,1
geographic and cartographic archival records,0,0,0,1,1
documents d'archives géographiques et cartographiques,0,0,0,1,1
competition,0,0,0,1,1
structural health monitoring,1,0,0,0,1
thermal effects,1,0,0,0,1
displacement,2,0,0,0,2
bridges,1,0,0,0,1
visual analysis,0,0,2,0,2
flash flood,0,0,1,0,1
hydraulics data,0,0,1,0,1
hydraulics,0,0,1,0,1
hydraulique,0,0,1,0,1
donnee,0,0,1,0,1
traitement des donnees,1,0,1,0,2
crue,0,0,1,0,1
lockdown,0,1,0,1,2
use,0,1,0,1,2
confinement,0,1,0,1,2
perception de l'espace,0,1,0,1,2
usage,0,1,0,1,2
topography,1,3,0,1,5
indexing,1,0,0,0,1
cross-domain,1,0,0,0,1
description,1,0,0,0,1
indexation,1,0,0,0,1
multi-source,1,0,0,0,1
apprentissage,1,0,0,0,1
vehicle routing,0,1,0,1,2
meta-heuristics,0,1,0,1,2
disaster preparedness,0,1,0,1,2
pca,0,0,1,1,2
klt,0,0,1,1,2
selection,0,1,0,0,1
landscape,0,0,0,3,3
first-passage time,0,0,0,1,1
continuous monitoring,1,0,0,0,1
drivers of deforestation,1,0,0,0,1
déboisement,1,0,0,0,1
forêt tropicale,1,0,0,0,1
suivi continu,1,0,0,0,1
cause du déboisement,1,0,0,0,1
gestalt,0,1,1,0,2
contour line,0,2,0,0,2
dsm/dtm,0,2,0,5,7
collaborative platform,0,1,0,1,2
error taxonomy,0,0,0,1,1
quality evaluation,0,0,0,1,1
scatnet,0,0,0,1,1
graph kernels,0,0,0,1,1
label noise,0,0,0,1,1
admm,0,0,0,1,1
recurrent neural network rnn,0,0,0,1,1
regression,0,0,0,3,3
monitoring,1,0,0,2,3
fuzzy logic,3,6,2,2,13
fusion d’informations,0,1,0,0,1
raisonnement spatial,0,1,0,0,1
forest loss detection,1,0,0,0,1
southeast asia,1,0,0,0,1
protected areas,1,0,0,0,1
near real time deforestation,1,0,0,0,1
forest alert,1,0,0,0,1
optical-sar comparison,1,0,0,0,1
french guiana,1,0,0,0,1
lock down,0,1,0,1,2
epidemic visualization,0,1,1,0,2
exploratory analysis,0,1,1,0,2
data processing,1,0,0,1,2
platform,1,0,0,1,2
fusion d'informations,0,1,0,0,1
raisonement spatial,0,1,0,0,1
global image descriptor,1,0,0,1,2
localization,3,0,1,2,6
side modality learning,1,0,0,1,2
depth from monocular,2,0,0,2,4
réseaux siamois,1,0,0,1,2
recherche d'images multimodales par contenu,1,0,0,1,2
review,0,0,0,1,1
geospatial images,0,0,0,1,1
very high spatial resolution,0,0,0,3,3
information visualization,0,0,1,0,1
flow data,0,0,1,0,1
urban mobility,0,0,1,0,1
pervasive data,0,0,1,0,1
human-centered computingvisualization geographic visualization,0,0,1,0,1
human-centered computingvisualizationvisualization design and evaluation methods--visualization techniques,0,0,1,0,1
industrial photogrammetry photogrammetry software point cloud computer vision,1,0,0,0,1
industrial photogrammetry,1,0,0,0,1
photogrammetry software,1,0,0,0,1
photogrammetry mapping aerial bundle adjustment unmanned aerial vehicle gps,1,0,0,0,1
conceptual model,0,1,0,0,1
capitalization,0,1,0,0,1
legacy,0,2,0,0,2
mega sport event,0,1,0,0,1
sport event,0,1,0,0,1
olympic games,0,1,0,0,1
très haute résolution,0,0,0,1,1
coastal erosion,1,0,0,0,1
landsat images,1,0,0,0,1
ndwi,1,0,0,0,1
sentinel images,2,0,0,1,3
shoreline,2,0,0,0,2
svm,2,0,0,0,2
autonomous navigation,2,0,0,0,2
textured mesh,2,0,0,0,2
navigation autonome,2,0,0,0,2
scans lidar,1,0,0,0,1
very high resolution aerial imagery,0,0,0,1,1
modèle 3d de ville,0,0,0,1,1
qualification,0,0,0,1,1
taxonomie,0,0,0,1,1
imagerie aérienne thr,0,0,0,1,1
mns,0,0,0,1,1
sentinels,0,0,0,1,1
gap filling,0,0,0,1,1
ablation study,0,0,0,1,1
geoportals,0,1,0,0,1
global sfm,1,0,0,0,1
bundle adjustement,1,0,0,0,1
structure approximation,1,0,0,0,1
visibility analysis,1,0,0,0,1
moving objects detection,1,0,0,0,1
mesh fusion,1,0,0,0,1
mesh mosaic,1,0,0,0,1
indoor reconstruction,1,0,0,0,1
integration of geographic data,0,1,0,0,1
collaborative mechanisms,0,1,0,0,1
intégration données géographiques hétérogènes,0,1,0,0,1
qualité de données géographiques,0,1,0,0,1
mécanisme collaboratifs,0,1,0,0,1
visually impaired,0,1,0,0,1
spatio-temporal analysis,0,0,0,1,1
recreation,0,0,0,2,2
analyse spatio-temporelle,0,0,0,2,2
activités récréatives,0,0,0,1,1
carto-vandalism,0,1,0,0,1
données géographiques collaboratives,0,1,0,0,1
carto-vandalisme,0,1,0,0,1
qualité,0,1,0,1,2
géorisques,0,1,0,0,1
fusion de données,0,1,0,1,2
basol,0,1,0,0,1
basias,0,1,0,0,1
sis,0,1,0,0,1
s3ic,0,1,0,0,1
aria,0,1,0,0,1
bases de données publiques,0,1,0,0,1
fusion et intégration de données,0,1,0,0,1
activités industrielles polluantes,0,1,0,0,1
high resolution satellite images,1,0,0,0,1
worldview-2,1,0,0,0,1
foam,1,0,0,0,1
image indexing,2,0,0,1,3
siamese neural network,1,0,0,1,2
indexation d'images par le contenu,1,0,0,1,2
réseau de neurones siamois,1,0,0,1,2
augmented reality,0,0,3,0,3
situated visualization,0,0,1,0,1
multi-scale,0,1,0,0,1
thematic maps,0,1,0,0,1
immersive analytics,0,0,1,0,1
extended reality,0,0,2,0,2
user studies,0,0,1,0,1
apprentissage machine,0,1,0,0,1
enrichissement de données,0,1,0,0,1
vandalism,0,4,0,0,4
spatial synthetic data,0,0,0,1,1
analogue aerial images,1,0,0,0,1
index terms-deep learning,0,0,0,2,2
crop type classification,0,0,0,2,2
multi-temporal,0,0,0,2,2
sdi,0,1,0,0,1
provenance,0,1,0,0,1
mediation,0,1,0,0,1
bundle block adjustment multi-head camera systems oblique images constrained cameras orientation,1,0,0,0,1
bundle block adjustment,1,0,0,0,1
multi-head camera systems,1,0,0,0,1
oblique images,2,0,0,0,2
constrained cameras,1,0,0,0,1
orientation,2,0,0,2,4
patron linguistique,0,0,0,1,1
immersion,0,0,1,0,1
geographic information retrieval,0,1,0,0,1
nominal entity recognition,0,1,0,0,1
distortion,0,0,1,0,1
simplicial complexes,3,0,0,0,3
geometry,5,0,3,5,13
camera calibration interior orientation lens distortions corridor mapping uavs,1,0,0,0,1
camera calibration,1,0,0,0,1
interior orientation,1,0,0,0,1
lens distortions,1,0,0,0,1
corridor mapping,2,0,0,0,2
photogrammetry laser-scanning lidar hybridizing imu time-dependent errors uavs,1,0,0,0,1
laser-scanning,1,0,0,0,1
hybridizing,1,0,0,0,1
time-dependent errors,1,0,0,0,1
shipping flows,0,2,0,0,2
port hierarchy,0,1,0,0,1
vessel movements,0,1,0,0,1
complex networks,0,2,0,0,2
container shipping,0,1,0,0,1
green infrastructure,0,1,0,0,1
ecological networks,0,1,0,0,1
archival aerial images,0,0,0,2,2
orthophotograph,1,0,0,1,2
données géographiques vecteur,1,0,0,1,2
orthophotographies,1,0,0,1,2
sulfur-oxidizing bacteria,1,0,0,0,1
sulfur- oxidizing bacteria,1,0,0,0,1
anoxia,1,0,0,0,1
thermal deformation,1,0,0,0,1
cmos,1,0,0,0,1
metrology,4,0,0,0,4
urban sprawl,0,0,0,1,1
variability,0,0,0,1,1
étalement urbain,0,0,0,1,1
étude de variabilité,0,0,0,2,2
aide à la décision,0,0,0,2,2
aménagement,0,0,0,2,2
partial nonnegative matrix factorization,0,0,0,1,1
detection and area estimation,0,0,0,1,1
photovoltaic panels,0,0,0,1,1
photovoltaique panel,0,0,0,1,1
demelangeage spectral,0,0,0,1,1
registration,1,0,0,1,2
recalage,1,0,0,0,1
modèle 3d de villes,1,0,0,0,1
floating car data,0,1,0,0,1
speed profile,0,1,0,0,1
apprentissage statistique,0,1,0,0,1
signalisation routière,0,1,0,0,1
profil de vitesse,0,1,0,0,1
cartographie routière,0,1,0,0,1
evolutionnary algorithms,0,0,0,1,1
distributed computing model,0,0,0,1,1
insar corner cube,1,0,0,0,1
vhr data,0,0,0,1,1
error,0,0,0,3,3
multiplexing tools,0,0,1,0,1
sentiment,0,1,0,1,2
oral corpus,0,1,0,1,2
spanish republicans,0,1,0,1,2
nom de lieu,0,1,0,1,2
vectorisation,0,0,0,1,1
révolution française,0,0,0,1,1
ehess,0,0,0,2,2
france xviiie siècle,0,0,0,1,1
xviiie siècle,0,0,0,1,1
carte,0,1,0,1,2
vectorisation cartographie,0,0,0,1,1
chec,0,0,0,1,1
cartes anciennes,0,0,0,1,1
clermont,0,0,0,1,1
paroisses constitutionnelles,0,0,0,1,1
redécoupages administratifs,0,0,0,1,1
toponymes,0,0,0,1,1
visibility,0,0,4,0,4
spatial data infrastructure dsi,0,0,0,1,1
products,0,0,0,1,1
services,0,0,0,1,1
delaunay,1,0,1,0,2
cloud computing,1,0,1,0,2
spark,1,0,1,0,2
dinsar,1,0,0,0,1
insar,2,0,0,0,2
imagerie radar,1,0,0,0,1
psi,1,0,0,0,1
déformation,1,0,0,0,1
urban land cover,0,0,0,1,1
land data service,0,0,0,1,1
sentinel 2,0,0,0,1,1
sentinel 1,0,0,0,1,1
europe,0,0,0,1,1
environnement urbain,0,0,0,1,1
bases de données spectrales,0,0,0,1,1
correction atmosphérique,0,0,0,1,1
kaunas,0,0,0,1,1
indirect spatial referencing,0,1,0,0,1
reference features,0,1,0,0,1
sketch map,0,1,0,0,1
dike monitoring,1,0,0,0,1
acquisition geometry,1,0,0,0,1
thermal effect,1,0,0,0,1
rolling shutter,1,0,0,0,1
suivi de digue,1,0,0,0,1
cartographie de corridorss,1,0,0,0,1
géométrie d'acquisition,1,0,0,0,1
effet thermique,1,0,0,0,1
obturateur roulant,1,0,0,0,1
human-centered computing → user interface design,0,0,1,0,1
digital libraries and archives,0,0,1,0,1
ccs concepts • computing methodologies → image-based rendering,0,0,1,0,1
information systems → geographic information systems,0,0,1,0,1
interférométrie radar différentielle,1,0,0,0,1
déformation du sol,1,0,0,0,1
phénomènes d'origine anthropique,1,0,0,0,1
mowing events,0,0,0,1,1
permanent grasslands,0,0,0,1,1
aerial imagery,0,0,1,1,2
analyse visuelle,0,0,1,0,1
abstraction,0,0,1,0,1
réalité augmentée,0,0,1,0,1
method,1,0,0,0,1
armed conflict,1,0,0,0,1
syria,1,0,0,0,1
environmental index,1,0,0,0,1
risk map,1,0,0,0,1
in-situ campaign,0,1,0,1,2
data update,0,1,0,1,2
index terms-classification,0,0,0,1,1
spot,0,0,0,1,1
urban land- scape,0,0,0,1,1
urban morpho-types,0,0,0,1,1
urban atlas,0,0,0,1,1
superspectral,0,0,0,1,1
sensor assessment,0,0,0,1,1
spectral configuration,0,0,0,1,1
urban materials,0,0,0,2,2
hapke photometric model,1,0,0,0,1
field goniometer,1,0,0,0,1
bayesian inversion,1,0,0,0,1
asal-ghoubbet rift,1,0,0,0,1
very high resolution digital elevation model,1,0,0,0,1
surface roughness,2,0,0,0,2
pleiades satellite,1,0,0,0,1
extended spatial relation,0,2,0,0,2
ague spatial objects,0,1,0,0,1
objets spatiaux vagues,0,2,0,0,2
segregation,0,0,0,1,1
health,0,0,0,1,1
metadata fitness for use urban land models quality reproducibility,0,1,0,0,1
fitness for use,0,1,0,0,1
urban land models,0,1,0,0,1
reproducibility,0,1,0,0,1
cognition,0,1,2,0,3
visual analytics,0,0,1,0,1
maps temporal visualization,0,0,1,0,1
immersive technologies,0,0,1,0,1
virtual reality,0,0,1,0,1
mixed reality,0,0,2,0,2
user-centric design,0,0,1,0,1
knowledge management,0,1,0,0,1
knowledge capitalization,0,1,0,0,1
knowledge management system,0,1,0,0,1
sport events,0,1,0,0,1
quality assessments,0,0,0,1,1
scalability,0,0,0,1,1
mental maps,0,1,0,0,1
smooth zooming,0,1,0,0,1
continuous generalisation,0,1,0,0,1
variability analysis,0,0,0,1,1
regulatory urban planning,0,0,0,1,1
excess commuting,0,0,0,1,1
territory,0,0,0,1,1
poster,0,0,0,1,1
index terms-camera relocalisation,1,0,0,1,2
multimodal data,1,0,0,1,2
icp,2,0,0,2,4
image colour analysis,1,0,0,1,2
learning artificial intelligence,1,0,0,1,2
robots,1,0,0,1,2
training,1,0,0,1,2
decoding,1,0,0,1,2
daytime images,1,0,0,1,2
learning scene geometry,1,0,0,1,2
outdoor large scale image,1,0,0,1,2
cross-season,1,0,0,1,2
learned global image descriptor,1,0,0,1,2
scene geometry information,1,0,0,1,2
depth map,1,0,0,1,2
query image,1,0,0,1,2
localization accuracy,1,0,0,1,2
cross-weather,1,0,0,1,2
long-term localization scenario,1,0,0,1,2
night images,1,0,0,1,2
winter localization sequence,1,0,0,1,2
summer localization sequence,1,0,0,1,2
estimation de pose de caméra,1,0,0,0,1
oceans,1,0,0,0,1
tsunami,1,0,0,0,1
sea measurements,1,0,0,0,1
image color analysis,1,0,0,0,1
geostationary ocean color imager goci,1,0,0,0,1
ocean color,1,0,0,0,1
suspended particulate matter spm,1,0,0,0,1
tohoku tsunami,1,0,0,0,1
camera model,1,0,0,0,1
subbands & subspace decomposition,1,0,0,0,1
adaptative coherent pseudocorrelation,1,0,0,0,1
coefficient of variation,1,0,0,0,1
contextual nonlinear filtering,1,0,0,0,1
digues,1,0,0,0,1
reconnaissance,1,0,0,0,1
auscultation,1,0,0,0,1
prévention,1,0,0,0,1
paroisses,0,0,0,1,1
stylization,0,1,1,0,2
handicap,0,1,1,0,2
information retrieval,0,1,0,0,1
heterogeneous and distributed data,0,1,0,0,1
vague spatial objects,0,1,0,0,1
change detection method,0,0,0,1,1
clear‐cuts detection method,0,0,0,1,1
orfeo toolbox image processing,0,0,0,1,1
cnes,0,0,0,1,1
optical satellite images,0,0,0,1,1
surface reconstruc- tion,1,0,0,0,1
texturing,2,0,0,0,2
semantization,1,0,0,0,1
lieux,0,1,0,1,2
long-term effects,1,0,0,0,1
instrumentation,1,0,0,0,1
controle non destructif,1,0,0,0,1
entretien,1,0,0,0,1
gestion du patrimoine d'infrastructure,1,0,0,0,1
appareil de mesure,1,0,0,0,1
surveillance de sante structurale,2,0,0,0,2
controle,1,0,0,0,1
conference,1,0,0,0,1
vignettage,1,0,1,0,2
correction de champ plat,1,0,1,0,2
ajustement de fonction,1,0,1,0,2
radiométrie des images,1,0,1,0,2
oriented images,1,0,0,0,1
sensor topology,2,0,0,0,2
inpainting,0,0,5,0,5
diffusion,0,0,1,0,1
orthophoto,0,0,1,0,1
orthoimage,1,0,1,1,3
mms,0,0,1,0,1
variational,0,0,1,0,1
points d'appui,0,0,0,1,1
images aériennes,0,0,0,1,1
ortho-image keywords  aerial images,0,0,0,1,1
modèle numérique de surface,0,0,0,1,1
shm,1,0,0,0,1
sructural health monitoring shm,1,0,0,0,1
controle de sante structurelle,1,0,0,0,1
pont suspendu,1,0,0,0,1
modele,1,0,0,0,1
pont de brotonne,1,0,0,0,1
systeme de geolocalisation et de navigation par satellites,1,0,0,0,1
modele numerique,1,0,0,0,1
topologie capteur,1,0,0,0,1
depth,0,0,0,1,1
urban 3d model,0,0,0,1,1
distances between histograms,1,0,0,1,2
detection of ruptures,2,0,0,2,4
hypotheses testing,1,0,0,1,2
log-likelihood ratio,1,0,0,1,2
significance level,1,0,0,1,2
decision fusion,0,0,0,1,1
spot 6/7,0,0,0,1,1
late fusion,0,0,0,1,1
regularization,5,0,0,6,11
artificialized area,0,0,0,1,1
fusion au niveau décision,0,0,0,1,1
fusion tardive,0,0,0,1,1
tache artificialisée,0,0,0,1,1
tache urbaine,0,0,0,1,1
port cities,0,1,0,0,1
multiplex graph,0,1,0,0,1
australia,0,1,0,0,1
centrality,0,1,0,0,1
intermodalism,0,1,0,0,1
forme,1,0,0,0,1
optimum,1,0,0,0,1
probleme inverse,1,0,0,0,1
coupe de graphe,2,0,0,0,2
gravitation,0,0,0,1,1
cosmology,0,0,0,1,1
experimental studies of gravity,0,0,0,1,1
gravitational waves,0,0,0,1,1
detection,2,0,2,1,5
ground control point,1,0,0,0,1
virtual reality vr,0,0,1,0,1
augmented reality ar,0,0,1,0,1
in situ,0,0,1,0,1
underground,0,0,1,0,1
cooperative fusion,1,0,0,1,2
low-level fusion,1,0,0,1,2
unmixing,2,0,0,3,5
temporal regularization,0,0,0,1,1
conditional random fields,0,0,0,1,1
outlier detection,0,1,0,0,1
2012 acm subject classification human-centered computing → collaborative content creation,0,1,0,0,1
computing methodologies → anomaly detection,0,1,0,0,1
hpc,0,2,3,1,6
partitioning,0,2,2,0,4
collaborative mapping,0,1,0,1,2
phenology,1,0,0,0,1
temperate forest,1,0,0,0,1
seasonal monitoring,1,0,0,0,1
temperate mixed forest,1,0,0,0,1
radar backscattering coefficient,1,0,0,0,1
interferometric coherence,1,0,0,0,1
simulated annealing,0,1,2,2,5
perception and recognition,0,1,1,0,2
design cartographic model,0,1,1,0,2
user experience,0,1,1,0,2
communication,0,2,1,0,3
visual signature,0,1,1,0,2
modèle de conception cartographique,0,1,1,0,2
expérience utilisateur,0,1,1,0,2
signature visuelle,0,1,1,0,2
perception et reconnaissance,0,1,1,0,2
index termsmulti-wavelets,1,0,0,0,1
information fusion,1,0,0,0,1
geometric differencing,1,0,0,0,1
multivariate synthetic aperture radar,1,0,0,0,1
image time series,1,0,0,0,1
image-based localization,2,0,0,2,4
camera relocalisation,1,0,0,1,2
learning with side information,1,0,0,1,2
localisation basée image,1,0,0,1,2
fusion de modalités,1,0,0,1,2
apprentissage via des données annexes,1,0,0,1,2
geovisualisation,0,1,2,0,3
graphical representation,0,0,1,0,1
représentation graphique,0,0,1,0,1
conception,0,0,1,0,1
aerial images,0,0,0,1,1
appariement de graphes,0,0,0,1,1
architecture soa,0,1,0,1,2
modélisation floue,0,1,0,1,2
intégration de données hétérogènes,0,1,0,1,2
secours à la personne,0,1,0,1,2
animation,0,0,2,0,2
image-based animation,0,0,1,0,1
crowdsourced data quality,0,1,0,0,1
point of interest,0,1,0,0,1
crowdsourced data evolution,0,1,0,0,1
intrinsic data quality assessment,0,1,0,0,1
extrinsic data quality assessment,0,1,0,0,1
spatial similarity measure,0,1,1,0,2
multi-criteria decision,0,2,1,0,3
java programming,0,1,1,0,2
unmanned aerial vehicle,1,0,0,0,1
calibration/synchronization,1,0,0,0,1
métrologie,1,0,0,0,1
calibration/synchronisation,1,0,0,0,1
recherche d'images,1,0,0,1,2
sld,0,0,1,1,2
trains d'ondes,0,0,0,1,1
traitement,0,0,0,1,1
co-design,1,0,0,0,1
real-time,1,0,0,0,1
stacking,1,0,0,0,1
inertial measurement unit,1,0,0,0,1
iso,1,0,0,0,1
lever-arm,2,0,0,0,2
interactive editing,0,0,1,0,1
total variation,0,0,3,1,4
depth maps,0,0,3,0,3
reflectance,0,0,2,0,2
flickr,0,1,1,0,2
social networks,0,1,0,0,1
custom-made map,0,1,0,1,2
visual property,0,1,0,1,2
visual property statistical feature,0,1,0,1,2
user test,0,1,0,1,2
semantic labeling,1,0,0,1,2
graphical models,1,0,0,1,2
label placement,0,1,0,0,1
mcmc,0,1,4,1,6
nom de lieu générique,0,1,0,1,2
républicain espagnol,0,1,0,1,2
migration,0,1,0,1,2
analyse de sentiment,0,1,0,1,2
minimisation d'énergie,1,0,0,1,2
sélection d'attributs,1,0,0,1,2
imagerie multispectrale,1,0,0,1,2
délimitation de peuplements forestiers,1,0,0,1,2
politique et actions,0,0,0,1,1
mesures,0,0,0,1,1
artificialisation des sols,0,0,0,1,1
processus,0,0,0,1,1
impacts,0,0,0,1,1
déterminants,0,0,0,1,1
rapport,0,0,0,1,1
cartographic continuum,0,1,1,0,2
interpolation,0,1,1,0,2
perception and cognition,0,1,1,0,2
passive data,0,2,0,0,2
données passives,0,1,0,0,1
enquête déplacements,0,1,0,0,1
matrice origine-destination,0,1,0,0,1
simplification,0,1,0,0,1
multiple representation,0,1,0,0,1
buffer,0,1,0,0,1
data privacy,0,1,0,0,1
ethics,0,1,0,0,1
legal issues,0,1,0,0,1
tree-like objects,0,0,1,1,2
semantic classification,0,0,1,1,2
soundscape,0,1,0,0,1
sound pleasantness,0,1,0,0,1
perceptive map,0,1,0,0,1
semiology of graphics,0,1,0,0,1
community and crowdsourcing platform,0,1,0,1,2
touristes,0,1,0,1,2
résidents,0,1,0,1,2
données géolocalisées,0,1,0,1,2
données de téléphonie,0,1,0,1,2
tourism,0,0,0,1,1
sentiers,0,0,0,1,1
mumford shah,0,0,0,1,1
working-set,0,0,0,1,1
greedy algorithm,0,0,0,1,1
minimal partition,0,0,0,1,1
smooth transitions,0,1,0,0,1
intermediate representation,0,1,0,0,1
rendering,0,0,1,0,1
continuités écologiques régionales,0,1,0,0,1
multi-level modeling,0,1,0,0,1
topographic mapping,0,1,0,0,1
hiking route maps,0,1,0,0,1
constraint solving problems,0,1,0,0,1
artificial intelligence,0,1,0,0,1
systèmes multi-agents,0,1,0,0,1
échelle,0,1,0,0,1
teledetection,0,0,0,1,1
milieu urbain,0,0,0,1,1
spatial regularization,0,0,0,1,1
belief propagation,0,0,0,1,1
image-based modeling technique,1,0,0,0,1
recherche d'images par contenu,1,0,0,1,2
saillance visuelle,1,0,0,1,2
descripteurs locaux,1,0,0,1,2
orientation des contours,1,0,0,1,2
multiple criteria decision,0,1,0,0,1
motion blur,0,0,1,0,1
inertial data,0,0,1,0,1
non-uniform/spatially-varying blur,0,0,1,0,1
svd,0,0,1,0,1
psf,0,0,1,0,1
fourier transform,1,0,1,0,2
flou de bougé,0,0,1,0,1
données inertielles,0,0,1,0,1
flou non uniforme et spatialement variant,0,0,1,0,1
décomposition en valeurs singulières,0,0,1,0,1
fonction d’étalement du point,0,0,1,0,1
transformée de fourier,0,0,1,0,1
interfaces graphiques,0,1,0,0,1
trajectory,0,0,0,1,1
density-based clustering,0,0,0,1,1
outdoor recreation activities,0,0,0,1,1
spatial references,0,0,0,1,1
imagerie hyperspectrale aéroportée,0,0,0,1,1
base de données spectrales,0,0,0,1,1
fusion de donénes hyperspectrales / lidar,0,0,0,1,1
démélange spectral/spatial,0,0,0,1,1
procedural,0,0,0,3,3
intégration,0,0,0,2,2
business process,0,1,0,0,1
quality management,0,1,0,0,1
outsourcing,0,1,0,0,1
ogc,0,0,1,1,2
inverse problem,0,0,0,1,1
procedural modelling,0,0,0,1,1
point cloud server,0,0,0,1,1
streetgen,0,0,0,1,1
rdbms,0,0,0,1,1
level of detail,0,2,0,1,3
niveaux de détails,0,0,0,1,1
terrasar-x,2,0,0,1,3
wetlands,1,0,0,1,2
synthetic-aperture radar,1,0,0,1,2
scatterometer data,1,0,0,1,2
amazon floodplain,1,0,0,1,2
edge-detection,1,0,0,1,2
water-level,1,0,0,1,2
task modelling,0,1,0,0,1
context,0,1,0,0,1
specification,0,1,0,0,1
user-generated,0,1,0,0,1
data capture rules,0,1,0,1,2
spécifications de saisie,0,1,0,1,2
pipeline,0,0,1,0,1
orthophotography,0,0,1,0,1
scan laser mobile,0,0,1,0,1
route,0,0,1,0,1
orthophotographie,0,0,1,0,1
sensor design,0,0,0,2,2
spectral libraries,0,0,0,1,1
swir,0,0,0,1,1
spectral band,0,0,0,1,1
bande spectrale,0,0,0,2,2
donnée hyperspectrale,0,0,0,1,1
contexte environnemental,0,0,0,1,1
geometric reconstruction from single images,0,0,1,0,1
generalized cylinders,0,0,1,0,1
3d circles,0,0,1,0,1
perspective projection,0,0,1,0,1
ccs concepts • human-centered computing~web-based interaction • human-centered computing~geographic visualization • human-centered computing~visualization toolkits keywords virtual globe,0,0,1,0,1
3d urban models,0,0,1,0,1
massive rendering,0,0,1,0,1
progressive streaming,0,0,1,0,1
view-dependent lod control,0,0,1,0,1
chunked-lod,0,0,1,0,1
synthesis,0,0,0,1,1
inference,0,0,0,1,1
rue,0,0,0,1,1
procédurale,0,0,0,1,1
inférence,0,0,0,1,1
airborne lidar data processing,0,0,0,1,1
airborne laser scanning,0,0,0,1,1
multi-layered forest structure,0,0,0,1,1
carbon,0,0,0,1,1
individual tree extraction,0,0,0,1,1
crown delineation,0,0,0,1,1
tides,0,0,1,0,1
opengl,0,0,1,0,1
coastal area,0,0,1,0,1
clutter,0,2,1,0,3
complexity,0,2,1,0,3
legibility,0,2,1,0,3
complexité,0,1,1,0,2
lisibilité,0,1,1,0,2
street- view,0,0,1,0,1
webgl,0,0,2,0,2
point based rendering,0,0,1,0,1
javascript,0,0,1,0,1
framework,0,0,1,0,1
navigation immersive,0,0,1,0,1
pointcloud,0,0,1,0,1
big- data,0,0,1,0,1
toponyms,0,1,0,0,1
geographic names,0,1,0,0,1
local bundle adjustment,0,0,1,0,1
amers visuels,0,0,1,0,1
marquages au sol,0,0,1,0,1
ajustement de faisceaux local,0,0,1,0,1
théorie des graphes,0,0,0,1,1
toponym,0,1,0,0,1
subjective place,0,1,0,0,1
web corpus,0,1,0,0,1
modelisation 3d,1,0,0,0,1
photogrametry,1,0,0,0,1
texture,1,0,0,0,1
wavelet transform,1,0,0,0,1
haralick,1,0,0,0,1
polarimetry,2,0,0,2,4
cartographie de la végétation,1,0,0,0,1
polarimétrie,1,0,0,0,1
apprentissage actif,0,0,0,1,1
parcelles agricoles,0,0,0,1,1
très haute résolution spatiale,0,0,0,1,1
pléiades,0,0,0,1,1
geographical databases,0,0,0,2,2
experimentation,0,0,0,1,1
indexes,0,0,0,1,1
airborne,0,0,0,2,2
mountaneous areas,0,0,0,1,1
large scale mapping,0,0,0,2,2
analysis,2,0,2,0,4
integration de donnees,0,1,0,0,1
railway network,0,1,0,0,1
structures,0,1,0,0,1
strokes,0,1,0,0,1
graph-cuts,1,0,1,0,2
debruitage,1,0,0,0,1
itinerary reconstruction,0,2,0,0,2
minimum spanning tree,0,1,0,0,1
angle histogram,1,0,0,1,2
distances,1,0,0,1,2
occupancy grids,1,0,1,0,2
k-d tree,1,0,1,0,2
point-to-triangle distance,1,0,1,0,2
toponymie / écologie historique / carte de répartition / changement climatique / fagus sylvatica,0,1,0,0,1
algorithme,0,0,0,1,1
enveloppe,0,0,0,1,1
applied glaciology,1,0,0,0,1
glacier flow,1,0,0,0,1
glacier mapping,1,0,0,0,1
glaciological instruments and methods,1,0,0,0,1
speckle,0,0,0,1,1
optical images,0,0,0,1,1
radar polarimétrique,0,0,0,1,1
optique multispectral,0,0,0,1,1
situated agents,0,1,0,0,1
mas design,0,1,0,0,1
multi-level mas,0,1,0,0,1
sma multi-niveaux,0,1,0,0,1
conception de sma,0,1,0,0,1
octree,1,0,1,0,2
mrdb,0,1,0,0,1
scalemaster 20,0,1,0,0,1
index terms-unmixing,1,0,0,1,2
polarimetric decomposition,1,0,0,1,2
functional space,0,0,0,1,1
espace fonctionnel,0,0,0,1,1
delay,1,0,0,0,1
toponym resolution,0,1,0,0,1
expression of motion,0,1,0,0,1
point process,0,0,1,1,2
multi-level modelling,0,2,0,0,2
spatialised problems,0,2,0,0,2
constraints solving,0,2,0,0,2
raman lidar,1,0,0,0,1
water vapor,1,0,0,0,1
fouille préhistorique,1,0,0,0,1
chézy sur marne,1,0,0,0,1
photogrammétrie rapprochée,1,0,0,0,1
corrélationdense,1,0,0,0,1
gps and vhf localizations,0,0,0,1,1
spatial preference,0,0,0,1,1
obstacle,0,0,0,1,1
aménagement du territoire,0,0,0,1,1
préférence spatiale,0,0,0,1,1
bases de données géographiques,0,0,0,1,1
localisations gps et vhf,0,0,0,1,1
feature,1,0,1,1,3
vertical imagery,1,0,1,1,3
aerial,1,0,1,1,3
opening detection,1,0,1,1,3
geographic features,0,0,0,1,1
displacement monitoring,1,0,0,0,1
landslide,1,0,0,0,1
multi-view stereophotogrammetry,1,0,0,0,1
histoire urbaine,0,0,0,1,1
saint-jean-de-latran,0,0,0,1,1
crédit,0,0,0,1,1
3d geographic data,0,0,0,1,1
urban local plan,0,0,0,1,1
données géographiques 3d,0,0,0,1,1
génération de bâtiments,0,0,0,1,1
single tree detection,0,0,1,0,1
local maxima filtering,0,0,1,0,1
stochastic model,0,0,1,0,1
energy,0,0,1,1,2
old maps,0,0,0,2,2
carte ancienne,0,0,0,2,2
lidar aéroporté,0,0,0,1,1
biomasse aérienne,0,0,0,1,1
forêt multi-couche,0,0,0,1,1
interconnection,0,0,0,1,1
geographic reference,0,0,0,1,1
multi-scale visualization,0,0,0,1,1
interconnexion,0,0,0,1,1
référentiel géographique,0,0,0,1,1
brouillard,2,0,0,0,2
distance de visibilite,1,0,0,0,1
traitement des images,1,0,0,0,1
conic reconstruction,0,0,1,0,1
multi-view,0,0,1,0,1
trajectoires,0,0,0,1,1
espace géographique,0,0,0,1,1
processus ponctuels marqués,0,0,0,1,1
bâtiments,0,0,0,1,1
imagerie satellitaire à très haute résolution,0,0,0,1,1
enquête mobilité,0,0,1,0,1
fauna movement,0,0,0,1,1
point cloud registration,0,0,0,1,1
neighborhood change detection,0,0,0,1,1
dimensionality,0,0,0,1,1
eigenvalues,0,0,0,1,1
point homologue,1,0,0,0,1
stéréo,1,0,0,0,1
sift,1,0,0,0,1
cartographie conforme,1,0,0,0,1
image restauration,1,0,0,0,1
restauration d'image,1,0,0,0,1
field campaign,1,0,0,1,2
high spatial and spectral resolution,1,0,0,1,2
material optical properties,1,0,0,1,2
imagerie aeroportee,1,0,0,1,2
campagne experimentale,1,0,0,1,2
proprietes optiques des materiaux,1,0,0,1,2
haute resolution spatiale et spectrale,1,0,0,1,2
milieux urbains,1,0,0,1,2
support vector machines,0,0,0,1,1
seashore,0,0,0,1,1
administrative units,0,1,0,1,2
unités administratives,0,1,0,1,2
coordinates reference systems,0,0,0,1,1
systèmes de référence de coordonnées,0,0,0,1,1
geometric primitives,0,1,0,1,2
primitives géométriques,0,1,0,1,2
hierarchical object model,0,0,1,1,2
multi-view stereo,0,0,1,0,1
hybrid representation,0,0,1,0,1
jump-diffusion,0,0,1,0,1
esthétique,0,0,1,0,1
couleurs,0,0,1,0,1
sémiotique visuelle,0,0,1,0,1
reference data,0,0,0,1,1
thematic dataset,0,0,0,1,1
données de référence,0,0,0,1,1
dataset de référence géographique,0,0,0,1,1
ensemble de données thématique,0,0,0,1,1
toponyme,0,1,0,0,1
information spatiale,0,1,0,0,1
écriture des topony mes,0,1,0,0,1
bdnyme,0,1,0,0,1
ressource lexicale,0,1,0,0,1
dem/dtm,1,0,1,0,2
scalemaster,0,1,0,0,1
multi-representation database,0,1,0,0,1
image correlation,1,0,0,0,1
volcanic terrains,1,0,0,0,1
roughness anisotropy,1,0,0,0,1
microtopography,1,0,0,0,1
conflation,0,1,0,0,1
least squares,0,1,0,0,1
shape,0,1,0,0,1
satellite stereoscopic images,1,0,0,0,1
projective multi-texturing,0,0,1,0,1
lod1 3d city model,0,0,1,0,1
updating,0,0,0,1,1
2d topographic database,0,0,0,1,1
non-rigid registration,1,0,0,0,1
3d geometric model,1,0,0,0,1
recalage non-rigide,1,0,0,0,1
modèle géométrique 3d,1,0,0,0,1
human migration,0,1,0,0,1
flow mapping,0,1,0,0,1
spatiotemporal filtering,0,1,0,0,1
matrice origine destination,0,1,0,0,1
geographie,0,0,0,1,1
symbolic images,1,0,0,1,2
similarity search,1,0,0,1,2
generic c++ library,0,0,1,0,1
columbus,0,1,0,0,1
ohio,0,1,0,0,1
united states hal-02290913,0,1,0,0,1
bundle adjustment,1,0,1,0,2
3d modelling,1,0,1,0,2
légende,0,1,0,0,1
ontologie cartographique,0,1,0,0,1
règles,0,1,0,0,1
corese,0,1,0,0,1
stéréoscopie,1,0,0,0,1
régularisation spatiale,1,0,0,0,1
mise en correspondance,1,0,0,0,1
topographic databases integration,0,0,0,1,1
specifications,0,0,0,1,1
intégration de bases de données topographiques,0,0,0,1,1
appariement de schémas,0,0,0,1,1
spécifications,0,0,0,1,1
systèmes d'information géographiques,0,1,0,0,1
traitement de données géographiques,0,1,0,0,1
urban water,0,0,0,1,1
contaminant,0,0,0,1,1
methodology,0,0,0,1,1
rooﬁng materials,0,0,0,1,1
runoff,0,0,0,1,1
shape representation,0,0,0,1,1
point data,0,0,0,1,1
markov random field,0,0,0,1,1
sky radiance,0,0,1,0,1
illumination,0,0,1,0,1
environment map,0,0,1,0,1
terrestrial images,0,0,1,0,1
système d'information / information system,0,1,0,0,1
management de la connaissance,0,1,0,0,1
paysage,0,0,0,1,1
données localisées,0,0,0,1,1
social welfare,0,1,0,0,1
fauna movements,0,0,0,1,1
high-scale data,0,0,0,1,1
